z.	…
z,	‥
zh	←
zj	↓
zk	↑
zl	→
z-	〜
z[	『
z]	』
kv	き
kj	く
kl	こ
dv	で
nf	ぬ
n;	の
hv	ふ
mv	む
mk	み
ml	も
yv	ゆ
nv	ん

@a	ぁ
@i	ぃ
@u	ぅ
@e	ぇ
@o	ぉ
@ka	ヵ
@ke	ヶ
@tu	っ
@ya	ゃ
@yo	ょ
@yu	ゅ

ds	で	s
gs	ぐ	s
ms	ま	s
ks	か	s
rs	ら	s
ts	と	s
ws	わ	s

kr	か	r
cr	く	r
gr	ぐ	r
sr	す	r
tr	と	r
dr	ど	r
fr	ふ	r
pr	ぷ	r
mr	ま	r
yr	よ	r
wr	わ	r

gt	ご	t
kt	こ	t
mt	ま	t
wt	わ	t

dk	で	k
sk	し	k
tk	と	k
wk	わ	k

ca	ちゃ
cu	ちゅ
co	ちょ
cw	ちゅう
cv	ちょう

cs	くす
sc	すく
st	すと
ck	っく
rk	ーく
rt	ーと

b;	ぶ
c;	っく
d;	っど
f;	ふ
g;	っぐ
h;	う
k;	っく
l;	る
m;	む
p;	っぷ
q;	っく
z;	ず

b.	ぶ。
d.	だ。
g.	ぐ。
k.	く。
m.	む。
n.	ん。
r.	る。
s.	す。
t.	た。
v.	ぶ。

d,	で、
g,	が、
h,	は、
t,	て、
	
vw	びゅー

dy	だい

gf	がい
gv	ぎょう
gl	げい
gm	ぐん
gd	げん
gh	ごう
gn	がん

hf	はい
hn	はん
hb	ほん
hg	ひん
hl	へい

jh	じょう
jn	じゃん
jm	じゅん
jv	じょう
jw	じゅう
jy	じゃい

kf	かい
kn	かん
kg	きん
kb	こん
kd	けん
km	くん
kh	こう
ky	かい

xw	しゅう
xv	しょう

my	まい
mn	まん
mg	みん
mb	もん
md	めん
mh	もう

la	りゃ
lu	りゅ
lo	りょ
lh	りょう

qa	きゃ
qn	きゃん
qu	きゅ
qw	きゅう
qo	きょ
qv	きょう

sf	さい
sn	さん
sg	しん
sm	すん
sl	せい
sd	せん
sh	そう
sb	そん

tf	たい
tn	たん
tg	ちん
tw	つう
tm	つん
tl	てい
td	てん
tb	とん

xa	しゃ
xu	しゅ
xo	しょ
xm	しゅん

yh	よう

zf	ざい
zd	ぜん
zb	ぞん
zg	じん
